"transaction_id","user_id","status","transaction_type","amount","remarks","balance_before","balance_after","created_date"
fbe8880c-4dd9-426f-8fba-ddd16a06c6b9,efd8412d-e517-4fdb-a85b-32cf6fbd04cb,SUCCESS,CREDIT,50000.00,,0.00,50000.00,2025-01-26 12:49:15.833
a5177584-8f5b-4049-b9e6-367aaefc8040,efd8412d-e517-4fdb-a85b-32cf6fbd04cb,SUCCESS,DEBIT,10000.00,pulsa,50000.00,40000.00,2025-01-26 12:50:18.842
"3d3dcda5-ac61-4c80-bf11-7a86461c4220",efd8412d-e517-4fdb-a85b-32cf6fbd04cb,SUCCESS,DEBIT,10000.00,lunch,40000.00,30000.00,2025-01-26 12:51:09.766
"951b57c1-61d0-436a-bf04-fa336938349a",efd8412d-e517-4fdb-a85b-32cf6fbd04cb,SUCCESS,DEBIT,10000.00,lunch,30000.00,20000.00,2025-01-26 12:52:49.914
"6647ed38-7a2a-4fe2-9e38-706f3c863d8e",efd8412d-e517-4fdb-a85b-32cf6fbd04cb,SUCCESS,DEBIT,10000.00,lunch,20000.00,10000.00,2025-01-26 12:54:32.748
"649dd218-39d1-48cb-b1a4-7aa673e47435",efd8412d-e517-4fdb-a85b-32cf6fbd04cb,SUCCESS,DEBIT,10000.00,lunch,10000.00,0.00,2025-01-26 13:11:42.301
a0b02d9e-5194-4666-9993-52b8603ab60c,"7f8f7c26-501b-4be0-bdc4-a84d7030b5a9",SUCCESS,CREDIT,10000.00,lunch,0.00,10000.00,2025-01-26 13:11:42.308
